WWWWWWWWWWWWWWWWWWWWWWWWWWWWW
WFFFFFFFFFFFFWWWFFFFFFFFFFFFW
WFWWWWFWWWWWFWWWFWWWWWFWWWWFW
WEWWWWFWWWWWFWWWFWWWWWFWWWWEW
WFWWWWFWWWWWFWWWFWWWWWFWWWWFW
WFFFFFFFFFFFFFFFFFFFFFFFFFFFW
WFWWWWFWWFWWWWWWWWWFWWFWWWWFW
WFFFFFFWWFFFFWWWFFFFWWFFFFFFW
WWWWWWFWWWWW WWW WWWWWFWWWWWW
     WFWWWWW WWW WWWWWFW     
     WFWWW         WWWFW     
     WFWWW WWWDWWW WWWFW     
WWWWWWFWWW WW   WW WWWFWWWWWW
      FF   WWWWWWW   FF      
WWWWWWFWW           WWFWWWWWW
     WFWW WWWWWWWWW WWFW     
     WFWW WWWWWWWWW WWFW     
WWWWWWFWW WWWWWWWWW WWFWWWWWW
WFFFFFFFFFFFFWWWFFFFFFFFFFFFW
WFWWWWFWWWWWFWWWFWWWWWFWWWWFW
WFWWWWFWWWWWFWWWFWWWWWFWWWWFW
WEFFWWFFFFFFFFFFFFFFFFFWWFFEW
WWWFWWFWWFWWWWWWWWWFWWFWWFWWW
WWWFWWFWWFWWWWWWWWWFWWFWWFWWW
WFFFFFFWWFFFFWWWFFFFWWFFFFFFW
WFWWWWWWWWWWFWWWFWWWWWWWWWWFW
WFWWWWWWWWWWFWWWFWWWWWWWWWWFW
W             S             W
WWWWWWWWWWWWWWWWWWWWWWWWWWWWW